............................
............................
.......##&########&##.......
.........=........=.........
..../....=........=.........
....%##?%##########%?##%....
....@...@..........@...@....
....@...@..........@...@....
...%###?#####%######?###%...
...@.........@..........@...
...@.........@..........@...
..%####?#%########%#?####%..
..@......@........@......@..
..@......@........@......@/.
.%#####?#####%######?#####%.
.@...........@............@.
.@...........@../.........@.
############################