............................
............................
.........##########.........
.........=........=.........
.........=........=.........
....%##?%##########%?##%....
....@...@..........@...@....
....@...@..........@...@....
...%###?#####%######?###%...
...@.........@..........@...
...@.........@..........@...
..%####?#%########%#?####%..
..@......@........@......@..
..@......@........@......@..
.%#####?#####%######?#####%.
.@...........@............@.
.@...........@............@.
############################