............................
............................
.......##&########&##.......
.........=........=...."....
..../....=........=.........
....%##?%##########%?##%....
....@...@..."......@...@....
....@...@..........@...@....
...%###?#####%######?###%...
...@.........@..........@...
...@.........@..........@...
..%####?#%########%#?####%..
..@......@......".@......@..
..@......@........@......@/.
.%#####?#####%######?#####%.
.@...........@............@.
.@...........@../.........@.
############################